T.T...X...X...X...TT
...X.X...T.T...X....
X.X...X...X...X.X..X
.T.T...X.....X...T.T
X...X...X.X.X...X...
...X.X.......X.X.X..
T.T...X..T.T..X...TT
...X.X...T.T...X....
X.X...X.......X.X..X
.T.T...X..T.T..X...T
X...X...X.T.T.X...X.
...X.X...X...X...X..
T.T...X.X...X.X...TT
...X.X...T.T...X....
X.X...X...X...X.X..X

2
8