....................
.T................T.
....................
....................
....................
.......TTTTTT.......
.......TTTTTT.......
.......TTTTTT.......
.......TTTTTT.......
.......TTTTTT.......
.......TTTTTT.......
....................
....................
....................
....................
....................
....................
....................
.T................T.
....................

3
5