XXXXXXXXXXXXXXX
X.............X
X..T.......T..X
X.............X
XXXX..XXXX.XXXX
...............
XXXX..XXXX.XXXX
X.............X
X..T.......T..X
X.............X
XXXXXXXXXXXXXXX
...............
....TTTTTTT....
...............
XXXXXXXXXXXXXXX

2
4