T.X.T.X.T.X.T.X.T.X.
.X.X.X.X.X.X.X.X.X.X
..T...T...T...T...T.
X.X.X.X.X.X.X.X.X.X.
.T.X.T.X.T.X.T.X.T.X
X.X.X.X.X.X.X.X.X.X.
....................
XXXX.XXXX.XXXX.XXXX.
T..X..T..X..T..X..T.
.X.X.X.X.X.X.X.X.X.X
....T.....T.....T...
X.X.X.X.X.X.X.X.X.X.
.T...T...T...T...T..
X.X.X.X.X.X.X.X.X.X.
....................
.XXXX.XXXX.XXXX.XXXX
..T.......T.......T.
X.X.X.X.X.X.X.X.X.X.
T...T...T...T...T...
....................

1
40